1111111111111111111111111111111111
1E0000000000000C10100C000000000001
1010010100100000000001000000010101
1000010010101010100001000000010101
1P0000000C00C0001010000000000001C1
1111111111111111111111111111111111